XXXXXXXXXXXXXXXXXXXXXXXXXXXXXXXXXXXXXXXXXXXXXXXXXXX
XXXXXXXXXXXXXXXXXXXXXXXXXXXXXXXXXXXXXXXXXXXXXXXXXXX
XX*                                 XXXXXXXXXXXXXXX
XX XXXX XXXXX XXXXXXXXXXXXXXXXXX XX XX         XXXX
XX XXXXXXXXXX XXXXXXXXXXXXXXXX X XX XX XXXXXXX    X
XX XXXXXXXXXX               XX X XX XX X    XX XX X
XX XXXXXXXXXXXXXXXXXXXXXXXX XX XXXX XX X XX XX XX X
XX XXXXXXXXX            XXX XX XXXX XX X  X XX XX X
XX XXXXXXXXX X XXXXXX XXX    XXXXXX XX XXXX XX XX X
XX XXXXXXXXX X XXXXXXXXXXXXXXXXXXXX XX      XX XX X
XX         X X XXXXXXXX             XXXXXXXXXX XX X
XXXXXXXXXXXXXXXXXXXXXXX XXXXXXXXXXXXXXXXXXXXXX XX X
XXX                                            XX X
XXX XXXXXXXXXXXXXXXXXXXXXXXXXXXXXXXXXXXXXXXXXXXXX X
XXX XXX                                      XXXX X
XXX XXX XXXXXXXXXXXXXXXXXXXXXXXXXXXXXXXXXXXX X    X
XXX XXX XX             XXXX    XXX        XX XXXX X
XXX XXX XX XXXX XX XXX XXXX XX XXX XXXXXXXXX XXXX X
XXX XXX XX XXXX XX XXX      XX               XXXXXX
XXX     XX XXXXXXXXXXXXXXXXXXXXXXXXXXXXXXXXXXXXXXXX
XXXXXXXXXX                                       XX
XXXXXXXXXXXXXXXX XXXXXXXXXXXXXXXXXXXXXXXX XXXXXX XX
XXXXXXXXXXXXXXXXXXXXXXXXXXXXXXXXXXXXXXXXXXXXXXXX XX
XX                                               XX
XX XXX XXXXXXXXXXXXXXXXXXXXXXXXXXXXXXXXXXXXXXXXXXXX
XX XXX XXX            X                        XXXX
XX XXX XXX XXXXXXXXXX X XXXXXXXXXXXXXXXX XXXXX XXXX
XX XXX XXX XXXXXXXXXX X XXXX  XXX     XX XX  X   XX
XX XXX XXX XXX    XXX X XXXXX XXX XXX XX XX XX X XX
XX XXX XXX XXX XX XXX X       XXX XXX XX XX XX X XX
XX XXX XXX XXX XX     X XXX XXXXX XXX XX    XX X XX
XX  XX     XXX XXXXXXXX XXX    XX XXX XX XXXXX X XX
XX XXXXXXXXXXX          XXXXXXXXX XXX XX   XXX X XX
XXXXXXXXXXXXXXXXXXXXXXXXXXXXXXXXX XXX XXXXXXXX X XX
XXXX                              XXX          X XX
XX X XXXXXXXXXXXXXXXXXXXXXXXXXXXXXXXXXXXXXXXXXXX XX
XX X XXXXXXXXXXXXXXXXXXXXXXXXXXXXXXXXXXXXXXXXXXXXXX
XX X XXX                                         XX
XX X XXX XXXXXXXXXXXXXXXXXXXXXXXXXXXXXXXXXXXXXXX XX
XX X XXX XX                  XXXXXXXXXXXXXXXXXXX XX
XX X XXX XX X XXXXXXXXXXXXXXXXXXXXXXXXXXXXXXXXXX XX
XX X XXX XX X X                                  XX
XX X XXX XX X X XXXXXXXXXXXXXXXXXXXXXXXXXXXXXXXXXXX
XX X XXX XX X X   XX     XX XXXXXX XXX XXXXXXXXXXXX
XX X XXX XX X X X XX XXX XX XXXXXX XXX XXX       XX
XX X XXX XX X X X XX XX                  X XXXXX XX
XX X XXX XX XXX X    XXXXXX XXXXX XXXXXX X XXXXX XX
XX X XXX    XXX XXXXXXXXXXXXXXXXXXXXXXXXXX XXXXX XX
XX X XXX XXXXXX                            XXXXX XX
XX       XXXXXXXXXXXXXXXXXXXXXXXXXXXXXXXXXXXXXXX XX
XXXXXXXXXXXXXXXXXXXXXXXXXXXXXXXXXXXXXXXXXXXXXXXXEXX
XXXXXXXXXXXXXXXXXXXXXXXXXXXXXXXXXXXXXXXXXXXXXXXXXXX